być w stanie, móc = moći
o (czyms) = o (cel.)
accept, to prihvaćati; primati, primiti
accommodation smještaj (m)
księgowa = računovođa (m)
boleć = boljeti
poprzez,w poprzek = preko (dop.)
addres = adresa (f)
przyznawać (rację itp.) = priznati
reklama,ogłoszenie = oglas (m)
dział reklamy = reklamni odjel(m)
radzić, poradzić = savjetovati
samolot = avion (m); zrakoplov (m); avionski, -a, -o
po (czas) = poslije (dop.)
ponownie, znowu = opet; ponovo
przeciw (czemuś) = protiv (dop.)
agencja = agencija (f)
zgadzać się = slagati se
uzgodniony = dogovoren, -a, -o
porozumienie, umowa = dogovor (m)
port lotniczy = aerodrom (m); zračna luka (f)
budzenie tel. = telefonsko buđenje (n)
wszystko(ie) = sav, sva, sve
w porządku = u redu
prawie = skoro
sam(a/o) = sam, -a, -o
gotowy(już) = već
także, również = također
zawsze = uvijek
karetka = kola za hitnu pomoć (pl)
Ameryka = Amerika (f)
i = i; a
zły = ljut, -a, -o
angry, to be ljutiti se
announce, to prijavljivati, prijaviti
inny = drugi, -a, -o
antybiotki = antibiotik (m)
aperitiw = aperitiv (m)
przepraszać = ispričavati se, ispričati se
podejść, podchodzić = to prilaziti, prići
kwiecień = travanj (m)
obszar,region = kraj (m)
koniec (czasu) = kraj (m)
ramię = ruka (f)
fotel = naslonjač (m)
około, po = oko (with gen. case); po (with dat. case)
arrive, to stizati, stići
jako = kao
as far as do (with gen. case)
jak tylko, gdy tylko = čim
pytać = pitati
ask for, to moliti, zamoliti
ask for girl's hand in marriage, to zaprositi
aspiryna = aspirin (m)
o (godzinie) = u (with acc. case)
at the house of kod (with gen. case) athletic atletski, -a, -o
ciotka = strina (f); tetka (f); ujna (f)
kawaler = samac (m)
plecy = leđa (n pl)
wstecz, w tył = natrag
źle = loš, -a, -e
torba, reklamówka = taška (f)
balkon = balkon (m)
bank = banka (f)
bar = bar (m)
grill, ruszt = roštilj (m)
koszykówka = košarka (f)
kąpać się = kupati se
łazienka = kupaonica (f)
zatoka = zaljev (m)
być = biti
plaża = plaž (m)
piękny = lijep, -a, -o
ponieważ = zato što
become, to postajati, postati
łóżko = krevet (m)
sypialnia = spavaća soba (f)
piwo = pivo (n)
przed = prije (with gen. case)
prosić o coś = to moliti, zamoliti
zaczynać = počinjati, početi
początek, rozpoczęcie = početak (m)
zachowanie, postępowanie = ponašanje (n)
za (czymś) = za (with ins. case)
lepszy = bolji, -a, -e
poprawiać się (zdrowie) = ozdravljati, ozdraviti
duży, wielki = velik, -a, -o
rachunek = račun (m)
czarny = crn, -a, -o
block of (lats blok (m)
blonde plav, -a, -o
blue plav, -a, -o
łódź = brod (m); čamac (m)
książka = knjiga (f)
budka, kabina = kabina (f)
urodzony = rođen, -a, -o
szef = šef (m)
kręgle = kuglana (f)
kod, pin = šifra (f)
brandy rakija (f)
chleb = kruh (m)
bułka tarta, okruszki = mrvice (f pl)
przerwa = pauza (f)
śdniadanie = doručak (m)
krótko = ukratko
jasny = vedar, -dra, -dro
doprowadzić, powodować = uvjetovati
brat = brat (m)
budowa, budowla = zgrada (f)
kantor = mjenjačnica (f)
autobus = autobus (m); autobusni, -a, -o
spotkanie biznesowe = poslovni sastanak(m)
zajety = zauzet, -a, -o
ale = ali, a
masło = maslac (m)
kupować = kupiti
zakupy = kupovina
opieka = kavana (f)
ciasto = kolač (m)
zadzwonić = zvati, nazvati
nazywać się = zvati se
móc = moći
samochód = auto (m); kola (n pl)
parking = parkiralište (n)
staranny, dbały = pažljiv, -a, -o
dywan = tepih (m)
case slučaj (m)
gotówka = gotov novac (m)
powodować, sprawić = uvjetovati
central središnji, -a, -e
centrum = centar (m)
pewny (ktoś) = siguran, -rna, -mo
krzesło = stolica (f)
zmiania, rozmieniać = mijenjati, promijeniti
rozmawiać = razgovarati
kasa sklepowa = blagajna (f)
kasjerka = blagajnica (f)
cheer up, to ohrabrivati, ohrabriti
ser = sir (m)
czek = ček (m)
dziecko = dijete (n)
children' s dječji, -a, -e
broda = brada (f)
boże narodzenie = Božić (m)
kościół = crkva (f)
papieros = cigareta (f)
kino = kino (n)
class sat (m)
clear vedar, -dra, -dro
urzędnik = službenik (m)
klimatyzacja = klima (f)
klinika = ambulanta (f); klinika (f)
zegar = sat (m)
zamknięte = zatvoren, -a, -o
chmura = oblak (m)
pochmurny = oblačan, -čna, -čno
wybrzeże = obala (f)
przybrzeżny = obalan, -Ina, -Ino
coastal region primorje (n)
kurtka = kaput (m)
code number (telephone) pozivni broj(m)
kawa = kava (f)
zimny(o) = hladan, -dna, -dno
cold (have a cold) prehlađen, -a, -o
kolega = kolega (m)
koleżanka = kolegica (f)
kolor = boja (f)
come, to dolaziti, doći
wygodny = komforan, -ma, -mo; udoban, -bna, -bno
firma = društvo (n); firma (f)
komputer = kompjutor (m); računalo (n)
komputerowy = kompjutorski, -a, -o
wniosek, konkluzja = zaključak (m)
stan = uvjet (m)
sala konferencyjna = sala za konferenciju(f)
przyznać się = priznati
gratulować = čestitati
zastanowić, rozważyć = razmišljati; smatrati
contact, to javljati se, javiti se
content sadržaj (m)
continue, to nastavljati, nastaviti
ciągle = stalno
contract ugovor (m)
rozmowa = razgovor (m)
gotować = kuhati
współpracować = surađivati
współpraca = suradnja (f)
kopia = kopija (f)
serdeczny = srdačan, -čna, -čno
róg (pokoju) = ugao (m)
kosztować (cena_ = koštati
kanapa = kauč (m)
kaszel = kašalj (m)
kaszleć = kašljati
okienko,lada = šalter (m)
counter clerk službenik (m)
wieś, przyroda = priroda (f)
kurs (języka) = tečaj (m)
kort (tenis) = igralište (n); teren(m)
karta kredytowa = kartica (f)
chorwacja = Hrvatska
chorwacki = hrvatski, -a, -o
chorwat = Hrvat (m)
chorwatka = Hrvatica (f)
cross, to prelaziti, prijeći
kulturowy = kulturan, -ma, -mo
filiżanka = šalica (f)
podstawka (filiżanki) = ormar (m)
currency valuta (f)
kurtyna = zavjesa (f)
tato = tata (m)
codzienny = dnevni, -a, -o
dalmacja = Dalmacija (f)
taniec = ples (m)
niebezpieczny = opasan, -sna, -sno
córka = kćerka (f)
dzień = dan (m)
decide, to odlučivati, odlučiti
dania = Danska
dentysta = zubar (m)
dział, departament = odjel (m)
zależeć od = zavisi od (with gen. case)
życzenie = želja (f)
życzyć = željeti
deser = slatko (n)
szczegółowy = detaljan, -ljna, -ljno
developed razvijen, -a, -o
dial the number, to okrenuti broj
trudny, cieżko = težak, -ška, -ško
jadalnia = blagovaonica (f)
obiad = večera (f)
jeść obiad = večerati
kierunek = pravac (m)
directly direktno
disappear, to nestajati, nestati
discuss, to razmatrati, razmotriti
danie = jelo (n)
disposal raspolaganje (n)
disposed raspoložen, -a, -o
daleko (i) = dalek, -a, -o
robić = raditi
doktor = doktor (m)
doktor = liječnik (m)
doctorka = liječnica (f)
operacja = ordinacija (f)
nie ma za co = nema na čemu
drzwi = vrata (n pl)
śnić = sanjati
dress haljina (f)
picie = piće (n)
drink, to piti, popiti
kierować = voziti
suchy = suh, -a, -o
dry, to sušiti se, osušiti se
dry clean, to kemijski čistiti
podczas, w czasie = tokom (with gen. case)
zmrok, zmierzch = sumrak (m)
każdy = svaki, -a, -o
ucho = uho (n)
wcześnie = rano
wschód = istok (m); istočni, -a, -o
łatwy = lak, -a, -o
jeść = jesti
ekonomiczny = privredni, -dna, -dno
jajko = jaje (n)
jeszcze, nadal, więcej, inny = još
emocja = osjećaj (m)
pusty = prazan, -zna, -zno
encourage, to ohrabrivati, ohrabriti
koniec = kraj (m)
zajęty = zauzet, -a, -o
engaged in, to be baviti se
England Engleska
English engleski, -a, -o
Englishman Englez (m)
Englishwoman Engleskinja (f)
dość, wystarczająco = dosta (with gen. case)
enter, to ulaziti, ući
wejście = ulaz (m)
koperta = koverta (f)
equipment oprema (f)
wieczór = večer (f)
event slučaj (m)
każdy = svaki, -a, -o
każdego dnia = svakodnevni, -a, -o
wszędzie = svugdje
oczywiście = očito
exact točan, -čna, -čno
examine, to razmatrati, razmotriti
doskonały = odličan, -čna, -čno
z wyjątkiem = osim (with gen. case)
kantor = mjenjačnica (f)
kurs (walut) = kurs (m)
podekstycowany - uzbuđen, -a, -o
ekskluzywny = isključiv, -a, -o
przepraszam = oprostite
exercise room trim kabinet (m)
exist, to postojati
wyjście = izlaz (m)
drogi = skup, -a, -o
eksport = izvoz (m)
extension (telephone) interni broj (m)
oko = oko (n)
fasada = fasada (f)
twarz = lice (n)
facility objekat (m); sadržaj (m)
upadać = padati
fall ill, to razboljeti se
rodzina = obitelj (f)
daleko = dalek, -a, -o
daleko od = daleko od (with gen. case)
szybko = brz, -a, -o
ojciec = otac (m)
faks = faks (m)
fee naplata (f)
feel osjećati se, osjetiti se
feeling osjećaj (m)
troche = neki, -a, -o
kilka, trochę = nekoliko
pole = polje (n)
wreszcie, w końcu =  konačno
find, to nalaziti, naći
find out, to saznati
palec = prst (m)
finish, to završavati, završiti
firma = firma (f)
pierwszy = prvi, -a, -o
first course predjelo (n)
ryba = riba (f)
fishing ribarski, -a, -o
mieszkanie = stan (m)
piętro =  kat (m)
mąka = brašno (n)
mgła =  magla (f)
following sljedeći, -a, -e
stopa =  noga (f)
piłka nożna = nogomet (m)
for jer; za (with acc. case)
obcokrajowiec = stran, -a, -o
las = šuma (f)
forget, to zaboravljati, zaboraviti
widelec = vilica (f)
France Francuska
French francuski, -a, -o
Frenchman Francuz (m)
Frenchwoman Francuskinja (f)
wolny(a) = slobodan, -dna, -dno
zamrażarka = zamrzivač (m)
świeży = svjež, -a, -e
lodówka = frižider (m)
przyjaciel = prijatelj (m)
przyjaciółka = prijateljica (f)
przyjacielski = prijateljski, -a, -o
from iz (with gen. case); od (withgen. case); s (with gen. case)
od kiedy = otkad
mróż = mraz (m)
smażyć = pržiti
pełny(a) = pun, -a, -o
full board puni pansion (m)
meble, umeblowanie = namještaj (m)
przyszłość = budućnost (f); budući, -a, -e
gra = igranje (n)
garaż = garaža (f)
ogrdód = vrt (m)
nazbierać, zganiać = skupljati se
menadżer = generalni direktor(m)
łagodny, delikatny = blag, -a, -o
gentleman gospodin (m)
Germany Njemačka
German njemački, -a, -o
German (man) Nijemac (m)
German (woman) Njemica (f)
otrzymać, dostać = dobiti
get off, to silaziti, sići
get up, to ustajati, ustati
dziewczyna = djevojka (f)
give,to davati, dati
chętnie, z przyjemnością = rado
szklanka = čaša (f)
iść = ići
go away, to odlaziti, otići
go behind, to zalaziti, zaći
go in, to ulaziti, ući
go out, to izlaziti, izaći
go up to, to prilaziti, prići
bóg = Bog (m)
dobry = dobar, -bra, -bro
dobranoc = laku noć (f)
dowidzenia = do viđenja; zdravo ( colloquial)
dobra, dorobek, towar = roba (f)
trawa = trava (f)
zielony = zelen, -a, -o
szary = siv, -a, -o
grill, ruszt =  roštilj (m)
parter = prizemlje (n)
gość = gost (m)
winny = kriv, -a, -o
włosy = kosa (f)
salon fryzjerski = frizerski salon (m)
połowa = polovica (f)
half board polupansion (m)
sala, hala = hala (f)
szynka = šunka (f)
ręka = ruka (f)
hand over, to predavati, predati
torebka, reklamówka = taška (f)
piłka ręczna = rukomet (m)
szczęśliwy - sretan, -ma, -mo
happen, to dešavati se, desiti se
port = luka (f)
kapelusz, czapka = šešir (m)
mieć = imati
musieć = morati
on = on
słyszeń = čuti (čujem)
ogrzać, rozgrzać = zagrijati
ogrzewanie = grijanje (n)
ciężki = težak, -ška, -ško
hello dobar dan; halo (on telephone); zdravo (colloquial)
her njen (njezin), -a, -o
tutaj = ovdje
tutaj jest = evo (with gen. case)
here you are izvolite
wahanie = kolebanje (n)
wysoki = visok, -a, -o
his njegov, -a, -o
hokej = hokej (m)
urlop = odmor (m)
holiday apartment apartman (m)
mieć nadzieję = nadati se
szpital = bolnica (f)
gorąco = vruć, -a, -e
hotel hotel (m)
godzina = sat (m)
dom (budynek) = kuća (f)
osiedlowy = naselje (n)
jak = kako
how come? kako to?
how many koliko (with gen. case)
how much koliko
jakkolwiek, jednak, niemniej = međutim
głodny = gladan, -dna, -dno
hurt, to boljeti (boli me...)
mąż = muž (m); suprug (m)
I ja
lód = led (m)
lody = sladoled (m)
jeśli = ako
ill bolestan, -sna, -sno
imagine, to zamišljati, zamisliti
od razu, natychmiast = odmah
import = uvoz (m)
ważne = važan, -Žila, -žno
w = u (with dat. case)
na przeciwko = ispred (with gen. case)
przemysłowy = industrijski, -a, -o
infekcja = infekcija (f)
informacja = informacije (f pl); podatak (m)
infrastruktura = infrastruktura (f)
mieszkaniec = stanovnik (m)
zamiar, intecja = namjera (f)
zapoznać = upoznati
zaproszenie = poziv (m)
invite, to pozivati, pozvati
Ireland Irska
prasować = glačati
wyspa = otok (m)
Istria Istra (f)
Italy Italija (f)
kurtka = jakna (f)
dżem = džem (m)
dołączyć, połączyć = spajati
wesoły = veseo, -la, -lo
podróż = put (m)
sok = sok (m)
June lipanj (m)
przed chwilą, dopiero co = upravo
klucz = ključ (m)
kind vrsta (f)
kind ljubazan, -zna, -zno
kiosk = kiosk (m)
kuchnia = kuhinja (f)
kolano = koljeno (n)
nóż = nož (m)
pukać, uderzyć = kucati
wiedzieć = znati
wiedza = znanje (n)
kuna = kuna (f)
gospodyni, właścicielka = gazdarica (f)
język = jezik (m)
wielki, ogromny = velik, -a, -o
last, to tra j a ti
póżno(-niej) = kasnije
pranie, pralnia = rublje (n)
prowadzić =  voditi
uczyć, nauczyć = učiti, naučiti
leave, to napuštati, napustiti; ostavljati, ostaviti
lewo = lijevo
noga = noga (f)
cytryna = limun (m)
let out, to izdavati
list = pismo (n)
życie = život (m)
lift lift (m)
light lagan, -a, -o; lak, -a, -o
jako, jak (ty) = kao
like, to sviđati se; voljeti
prawdopodobnie, pewnie... = vjerojatno
link, to spajati
usta = usna (f)
słyszeć, słuchać = slušati
mały = mali, -a, -o
mało, troszkę = malo
live, to stanovati; živjeti
dzienny pokój = dnevna soba (f)
lock, to zaključavati, zaključati
look (at), to gledati; pogledati
look (well), to izgledati (dobro)
look for, to tražiti
look forward to, to radovati se
ciężarówka = kamion (m)
lose, to gubiti, izgubiti
wiele, mnóstwo = mnogo (with gen.cas)
kochać(kogoś) = voljeti
bagaż = prtljaga (f)
obiad, lunch = ručak (m)
mieć lunch = ručati
Macedonia Makedonija (f)
Macedonian makedonski, -a, -o
Macedonian (man) Makedonac (m)
Macedonian (woman) Makedonka(f)
madam gospođa (f)
główny = glavan, -vna, -vno
make, to praviti, napraviti
człowiek = čovjek (m)
wiele, dużo = mnogo (with gen. case)
mapa = karta (f)
market tržište (n)
marketing marketing (m)
małżeństwo = brak (m)
married (of a man) oženjen
married (of a woman) udata
married, to get vjenčati se
married, to get (of a man) oženiti se
married, to get (of a woman) udati se
danie = jelo (n); obrok (m)
mean, to značiti
mięso = meso (n)
mechanik = mehaničar (m)
medicine medicina (f)
Mediterranean mediteranski, -a, -o
meet together, to skupljati se
spotkanie = sastanak (m)
menu = jelovnik (m)
wesoły, radosny = veseo, -la, -lo
wiadomość (np. sms) = poruka (fJ
środek, średni = sredina (f); središnji, -a, -e
mleko = mlijeko (n)
million = milijun (m)
Miss gospođica (f)
mgła, mgiełka = sumaglica (fJ
mieszany, pomieszany = miješan, -na, -no
chwila, moment = trenutak (m)
klasztor = samostan (m)
Monday ponedjeljak (m)
pieniądze = novac (m)
miesiąc = mjesec (m)
pomnik = spomenik (m)
więcej =  još; više
ranek = jutro (n); jutarnji, -a, -e
matka = majka (f)
autostrada  autocesta (f)
góra = planina (f)
usta = usta (n pl)
Mr gospodin (m)
Mrs gospođa (f)
much dosta (with gen. case); mnogo(with gen. case)
musieć = morati
mój = moj, -a, -e
imię = ime (n)
natura = priroda (f)
blisko, w pobliżu = blizu (with gen. case)
szyja = vrat (m)
potrzebować = trebati
nogecjacje = pregovori (m pl)
okolica, sąsiedztwo = okolina (f)
nowy = nov, -a, -o
gazeta = novine (f pl)
następny =  onda; zatim; sljedeći, -a, -e
next to kraj (with gen. case); pored(with gen. case)
nice lijep, -a, -o
noc = noć (f)
nie = ne
nikt = nitko
południe = podne (n)
północ = sjever (m); sjeverni, -a, -o
nos = nos (m)
zapisać = zapisivati, zapisati
nic = ništa
teraz = sada
numer = broj (m)
objekt = objekat (m)
oczywiście = očito
occupied with, to be baviti se
October listopad (m)
of course kako da ne; naravno
off s (with gen. case)
oferta = ponuda (f)
offer, to nuditi, ponuditi
biuro = ured (m)
olej = ulje (n)
OK u redu
old star, -a, -o
na = na (with dat. case)
pieszo = pješice
one jedan, -dna, -dno
oneself sebe
one's own svoj, -a, -e
tylko = samo
open otvarati, otvoriti
open otvoren, -a, -o
opinia = mišljenje (n)
lub = ili
zamówienie, zamówić = naručivati, naručiti
inny(a/e) = drugi, -a, -o
inaczej, w przeciwnym raziem = inače
nasz = naš, -a, -e
poza, na zewnątrz = izvan (with gen. case)
nocleg = noćenje (n)
wławny = vlastit, -a, -o
pakować, spakować się = pakovati, spakovati
naleśnik = palačinka (f)
rodzic = roditelj (m)
park = park (m)
parkować = parkirati
paszport = putovnica (f)
przeszłość = prošlost (f)
pauza, przerwa = pauza (f)
payoccupied with, to plaćati, platiti
płatność = plaćanje (n)
pokojowy =  miran, -rna, -mo
pokój = mir
pióro = pero (n)
pieprz = papar (m)
może = možda
osoba = čovjek (m); osoba (f)
pesymista = pesimist (m)
benzyna = benzin (m)
stacja benzynowa = benzinska stanica (f)
pinch together, to pritisnuti
pitch igralište (n); teren (m)
place mjesto (n)
plan = plan (m)
talerz = tanjur (m)
grać = igrati se
gra = igranje (n)
playing area igralište (n)
proszę (o coś) = molim
zadowolony = zadovoljan, -ljna, -ljno
kieszeń = džep (m)
Poland Poljska
policja = policija (f)
policjant = policajac (m)
posterunek policji = policijska postaja (f)
możliwość = mogućnost (f)
możliwe = mogući, -a, -e
poczta = pošta (f)
kartka pocztowa = razglednica (f)
praktyczny = praktičan, -čna, -čno
precise točan, -čna, -čno
przygotowywać = spremati
przygotowany = spreman, -mna, -mno
prezent = poklon (m)
cena = cijena (f)
cennik = cjenik (m)
prywatny = privatan, -tna, -tno
prawdopodobnie = vjerojatno
problem = problem (m)
produkt = proizvod (m)
produkcja = proizvođenje (n)
promenada = riva (f)
uczeń = učenik (m)
portfel = novčanik (m)
put, to stavljati, staviti
quay pristanište (n)
pytanie, pytać = ispitivati, ispitati
quick brz, -a, -o
cisza, cichy = tih, -a, -o
quite baš
deszcz = kiša (f)
deszczowy = kišovit
czytać, przeczytać = čitati, pročitati
gotowy = spreman, -mna, -mno
na prawde? = stvarno; zaista
otrzymać, otrzymywać, dostać = dobiti; primati, primiti
recepcja = recepcija (f)
polecać, polecany = preporučivati, preporučiti
recover, to ozdravljati, ozdraviti
czerwony = crven, -a, -o
region područje (n)
pozostały, ostatni = ostajati, ostati
pamiętać, zapamiętać = sjećati se, sjetiti se
wynająć coś = izdavati; iznajmljivati,iznajmiti
odpowiedź, odpowiedzieć = odgovarati, odgovoriti
przedstawiciel = predstavnik (m)
require, to trebati
rezerwować = rezervirati
reside, to stanovati
resignation ostavka (f)
respect poštovanje (n)
Respected (in a letter) Štovani,Štovana
odpoczynek = odmor (m)
odpocząć = odmarati se, odmoriti se
restauracja = restoran (m)
powrót = povratak (m)
wracać = vraćati se, vratiti se
prawo = desno; pravo (n)
rzeka = rijeka (f)
droga = cesta (f); put (m)
pokój = soba (f)
Russia Rusija
Russian ruski, -a, -o
Russian (man) Rus (m)
Russian (woman) Ruskinja (f)
smutny = tužan, -žna, -žno
sałatka = salata (f)
sprzedawca = prodavač (m)
sprzedawczyni = prodavačica (f)
salon = salon (m)
sól = sol (f)
same isti, -a, -o
sandały = sandale (f pl)
kanapka = sendvič (m)
zadowolony, usatysfakcjonowany = zadovoljan, -ljna, -ljno
Saturday subota (f)
rondel = tava (f)
say, to kazati; reći
szkoła = škola (f)
Scotland Škotska
ekran = ekran (m)
morze, morski = more (n); morski, -a, -o
wybrzeże = primorje (n)
drugi = drugi, -a, -o
sekretarka = sekretarica (f)
widzieć = vidjeti
wydawać się = činiti se
samoobsługa = samoposluga (f)
sprzedaż, sprzedawać = prodavati, prodati
wysyłka, wysłać = slati, poslati
osobny = poseban, -bna, -bno
September rujan (m)
Serbia Srbija
Serbian srpski, -a, -o
Serbian (man) Srbin (m)
Serbian (woman) Srpkinja (f)
służyć, serwować = služiti, poslužiti; usluživati
served, to be služiti se, poslužiti se
set off, to kretati, krenuti; polaziti,poći
szampon = šampon (m)
ona = ona
półka = polica (f)
shine, to sijati
statek, łódź = brod (m)
koszula = košulja (f)
buty = cipele (f pl)
sklep = prodavaonica (f)
niski,krótki = kratak, -tka, -tko
short lived kratkotrajan, -jna, -jna
short term kratkoročan, -čna, -čno
spodenki = šorc (m)
ramię = rame (n)
pokaz, pokazać = pokazivati, pokazati
prysznic = tuš (m)
brać prysznic = tuširati se, istuširati se
strona = strana (f)
śpiew, śpiewać = potpisivati, potpisati
od (czasu) = jer; otkad
szczerze = iskreno
śpiewać = pjevati
siostra = sestra (f)
siadać = sjesti
sitting, to be sjediti
situated smješten, -a, -o
situated, to be nalaziti se
łyżwiarstwo = klizanje (n)
narciarstwo = skijanje (n)
spódnica = suknja (f)
niebo = nebo (n)
Slavonia Slavonija (f)
spać = spavati
rękaw = rukav (m)
slice ploška (f)
Slovenia Slovenija (f)
Slovenian slovenski, -a, -o
Slovenian (man) Slovenac (m)
Slovenian (woman) Slovenka (f)
mały = mali, -a; -o
smashing sjajan, -jna, -jno
śnieg = snijeg (m)
więc =  tako
mydło = sapun (m)
society društvo (n)
skarpeta, torba, worek = čarapa (f)
żołnierz = vojnik (m)
some neki, -a, -o
ktoś = netko
coś = nešto
czasami = ponekad
gdzieś (tam) = negdje
syn = sin (m)
wkrótce = uskoro
przykrość = žao
sort vrsta (f)
zupa = juha
południe = jug (m); južni, -a, -o
space prostorija (f)
mówić = govoriti
mowa, przemowa = govor
specjalny = poseban, -bna, -bno
spend (time), to provoditi, provesti
łyżka = žlica (f)
sport = sport (m); sportski, -a, -o
rynek = trg (m)
kalmary = lignje (f pl)
stadion = stadion (m)
znaczek = marka (f)
stać = stajati
stacja = kolodvor (m)
stay, to boraviti; ostajati, ostati
ukraść = krasti, ukrasti
nadal, w dalszym ciągu = još uvijek
żołądek = stomak (m)
przystanek = stanica (f)
stop, to prestati; zaustavljati se, zaustaviti se
piętro, kondygnacja = kat (m)
burzowy = buran, -rna, -rno
prosty(o) = ravno
ulica = ulica (f)
silny = jak, -a, -o
study radna soba (f)
studiować = studirati
przedmieście = predgrađe (n)
sukces = uspjeh (m)
sugerować = predlagati, predložiti
sugestja = prijedlog (m)
suit odijelo (n)
suit, to odgovarati
lato = ljeto (n)
słońce = sunce (n)
opalać się = sunčati se
Sunday = nedjelja (f)
słońeczny = sunčan, -a, -o
emulsja do opalania = mlijeko za sunčanje (n)
olejek do opalania = ulje za sunčanje (n)
przypuszczać = pretpostavljati
pewnie(a) = siguran, -rna, -mo
pływać = plivati
pływanie = plivanje (n)
kostium kąpielowy = kupaći kostim(m)
basen = bazen (m)
system = sistem (m)
stół = stol (m)
stół do tenisa = stolni tenis (m)
wziąć, brać = uzimati, uzeti
take a holiday, to odmarati se,odmoriti se
take part in, to ba viti se
talk, to pričati
wysoki = visok, -a, -o
smak = ukus (m)
taxi = taksi (m)
herbata = čaj (m)
nauczyciel = nastavnik (m); učitelj(m)
nauczycielka = nastavnica (f); učiteljica (f)
telefon = telefon (m)
numer telefonu = telefonski broj (m)
telefonować = telefonirati
tell, to kazati; pričati; reći
temperatura = temperatura (f)
tenis = tenis (m)
taras = terasa (f)
niż, od (cos od kogos, czegos) =  nego
that da; što
that onaj, ona, ono; taj, ta, to
teatr = kazalište (n)
their njihov, -a, -o
then onda; tada; zatim
tam = tamo
they oni, one
cieńki, wąski = tanak, -nka, -nko
rzecz = stvar (f)
myśleć = misliti
trzeci = treći, -a, -e
spragniony = žedan, -dna, -dno
this ovaj, ova, ovo
tysiąc = tisuća (f)
trzy = tri
gardło = grlo (n)
przez (cos, droga) = kroz (with acc. case); po(with dat. case)
Thursday = četvrtak (m)
bilet = karta (f)
bilet 1 klasy = karta prvog razreda
bilet 2 klasy = ticket karta drugog razreda
bilet w jedną stronę = karta u jednom smjeru
bilet powrotny = povratna karta
czas = vrijeme (n)
zmeczony = umoran, -rna, -rno
to na (with acc. case); u (with acc.case)
toaleta = WC (m) (pronounced vetse)
tolerować = podnositi
jutro = sutra
język = jezik (m)
za dużo (za...) = previše; suviše
ząb = zub (m)
pasta do zębów = zubna pasta (f)
turystyka = turizam (m); turistički, -a, -o
turysta = turist (m)
turystka = turistkinja (f)
towards k (with dat. case); prema(with dat. case)
ręcznik = ručnik (m)
miasto = grad (m)
pociąg = vlak (m); vozni, -a, -o
tramwaj = tramvaj (m)
transfer = transfer (m)
transport = prijevoz (m)
dział transportu = transportni odjel (m)
podróżować = putovati
podróżnik = putnik (m)
traveller' s putnički, -a, -o
drzewo = drvo (n)
trend = trend (m)
spodnie = hlače (f pl)
prawda = istina (f)
próbować = probati
koszulka z krótkim rękawem = majica (f)
skręcać = skrenuti
dwa = dva, dvije
typowy = tipičan, -čna, -čno
parasol = kišobran (m)
wujek = stric (m); tetak (m); ujak (m)
pod = ispod (with gen. case)
rozumieć = razumjeti
bielizna = donje rublje (n)
niestety = na žalost
uniwersytet = sveučilište (n)
do, maksymalnie = do (with gen. case)
miejski = gradski, -a, -o
uzyć, używać = koristiti
użyteczny, przydatny = koristan, -sna, osno
zazwyczaj, przeważnie = obično
cielęcina = teleći, -a, -e
bardzo... = veoma; vrlo
sąsiędztwo, pobliże = blizina (f); okolina (f)
widok (na) = pogled (m)
wioska = selo (n)
visit, to posjećivati, posjetiti
czekać = čekati
kelner = konobar (m)
kelnerka = konobarica (f)
wstawać, budzić się = buditi se, probuditi se
portfel = novčanik (m)
chcieć = htjeti; željeti
gorący = topao, -pia, -pio
ogrzać, zagrzać = zagrijati
prać, wyprać = prati, oprati
woda =voda (f)
droga = put (m)
my = mi
słaby = slab, -a, -o
pogoda = vrijeme (n)
wesele = svadba (f)
kawałek = kriška (f) ???
środa = srijeda (f)
tydzień = tjedan (m)
zachód = zapad (m); zapadni, -a, -o
co = što
what kind of = kakav, okva, -kvo
kiedy = kada
gdzie = gdje
skąd = odakle
dokąd,gdzie (+ruch) = kamo
który = koji, -a, -e
podczas, w czasie = dok
dopóki = dok ne ...
biały = bijel, -a, -o
who koji, -a, -e; tko
cały = cijeli, -a, -o
czyj = čiji, -a, -e
dlaczego = zašto
żona = supruga (f); žena (f)
wiatr = vjetar (m)
okno = prozor (m)
wino = vino (n)
zima = zima (f)
życzenie = želja (f)
z = s (with ins. case)
bez = bez (with gen. case)
kobieta = žena (f)
wonderful divan, ovna, -vno; sjajan,-jna, -jna
słowo = riječ (f)
praca = posao (m)
pracować = raditi
pracujący = radni, -a, -o
martwić się, obawiać się = brinuti se
gorszy = gori, -a, -e
pisać = pisati, napisati
zły, błedny = kriv, -a, -o; pogrešan, -šna, -šno
rok = godina (f)
żółty = žut, -a, -o
tak = da
you = (singular) ti
you = (plural) vi
młody =  mlad, -a, -o
młoda = djevojka (f); gospođica (f)
your = (singular) tvoj, -a, -e
your = (plural) vaš, -a, -e
zero = nula (f)
zoo = zoološki vrt (m)
klinika = ambulanta
babcia = baka
chociaż, przynajmniej, co najmniej = barem
darmowe = besplatan (-tna)
notatnik = bilježnica
blady = blijed 
bluza = bluza
pielęgniarka = bloničarka
słodki = bombon
sosna = bor
pobyt = boravak
wzgórze = brijeg
caskada = buk
sztorm, północy wiatr = bura
opłata drogowa = cestarina???
kwiatek = cvijeće
często = često
dziwny = čudan(na)
być zaskoczonym = čuditi se
zatrzymać, zachować = čuvati (sačuvati)
= čuvati se ????
że, aby, żeby = da
oczywiście, jasne = dabome
stać się, zdarzyć się = desiti se
część = dio ???
dotykać = dirati
dziwić się = diviti se
czas, okres = dobar
podczas, w czasie = dok
dokaz = dowód (w sprawie)
przyjazd, dotarcie = dolazak
dolina = dolina
domowy =domaći
do pewnego stopnia = donekle
przynieść = donijeti (donesem, donositi)
wystarczające = dovoljan
doświadczyć = doživjeti
drogocenny = dragocjen
inny = drugačiji
towarzystwo (dotrzymać) = društvo
sklep = dućan
długi = dug
dusza = duša
być może = eventualno
formularz = formular
na górzy (domu) = gore
granica = granica
grom, grzmot = grmljavina
gubić = gubiti (izgubiti)
gumowy = gumen
gruby, gęsty = gust
gnieść, miąć = gužvati (izgužvati)
maska samochodu = bonnet
hlad ???
chodzić = hodati
chodnik = hodnik
inaczej, w przeciwnym razie = inače
zagranica = inozemstvo
zainteresować = interesirati
wart zachodu = isplatiti se
wyjść, wychodzić = izaći (izadem)
uniknąć, uciec = izbjeći
wybór = izbor
witryna, wyświetlacz = izlog
wyświetlać = izložiti
wyraz, wyrażenie, eksprecja = izraz
izvjestan ???
doskonały = izvrstan
bardzo = jako
poduszka = jastuk
ciężko = jedva
ponieważ = jer ???
jezioro = jezero
południe = jug
tego ranka = jutros
południowy = južni
późny = kasni
= kod ???
rutyna = kolotečina
część, kawałek = komad
konserwa = konzerva
walizka = kovčeg
skóra = koža
piękny = krasan (-na)
zatłoczony, pełny = krcat
umywalka = labavo
leżec = ležati (ležim)
lek = lijek
ładny,miły = lijep
likier = liker
= lopata ???
stukać (coś stuka) = lupati
piękno, uroda = lijepota
uprzejmny = ljubazan
materac = madrac
chusteczka = maramica
tłuszcz = mast
tłuszczowy = masni
międzynarodowy = medunarodni
= metnuti ???
siniak, śliwa = modrica
prośba, przysługa = molba
silnik = motor
martwy = mrtav (-va)
= nabaviti ???
= način ???
znaleźć = naći
biżuteria, klejnoty = nakit
po (czas...+G) = nakon
znajdować się = nalaziti se
zamierzać, planować = namjeravati
naprawić = napraviti
pokoloenie = naraštaj
talent = narav
naravno = ???
szczególnie = naročito
nachylaś, skłonić sie = nasloniti (se)
nawyk = navika
przyzwyczajony = navikao (navikla)
= navikati ???
nie daleko od = nedaleko
nie mieć = nemati
nieodparty = neodoljiv
bezpośredni, natychmiastowe = neposredan
nieprzyjemny, niesympatyczny = neprijatan
nieszczęście, wypadek = nesreća
niecierpliwy = nestrpljiv
nigdy = nikad
nigdy się... = nikad se
= nježan ???
nosić = nositi
 = obaviti ???
zazwyczaj = obično
= obilazak ???
wytłumaczyć, wyjaśniać = objasniti
stąd = odavde
dawno temu, od dawna = odavno
decydować się = odlučiti (se)
wychowany = odgojen
realacja = odnos ???
dorastać = odrasti ???
określony = određen
odespać, zdrzemnąć się = odspavati
nieobecność = odsutnost
odwieźć = odvesti ???
rozwidlenie drogi = odvojak
oddzielać, dzielić = odvojiti
oglądać się = ogledati se ???
okrągły = okrugao, okrugla
burza = oluja
 = omogućavati ???
 = omotnica ???
tutaj = ondje ???
niebezpieczny = opasan, opasna
operować = operirati ???
opisać = opisati
oporavak ???
staranny, dbały = oprezan
wybaczyć = oprostiti
orzech włoski = orah
szafa = ormar
oprócz, poza = osim
zostać , pozostawać = ostajati
pozostały = ostali
reszta, pozostałość = ostatak
zostawić = ostaviti ???
odświeżyć się = osvježiti se
odpłacić = otplaćivati
wyruszyć, wyprawiać się = otputovati
za = otraga
otwarty = otvoren
ovamo ???
zależnie, w zależności = ovisno
ovisi ???
poważny = ozbiljan (-na)
ożenić się = oženiti se
padać (na ziemię) = padati
pakować paczkę = pakiranje
para (dwie) = par
pies = pas
pasztet = pašteta
 = paziti ???
prasować = peglati ???
krajobraz = pejzaž
piana = pjena
pisarz = pisac
pić = piti
pijesma ???
poeta = pijesnik
wypłata = plaća
płacić = plaćati
gaz = plin
urodzajny, rozdrodczy = plodan ???
początek = početak
pod = pod
podnieść = podići
podnositi???
pojeść = pojesti
próbować (cos zrobic) = pokušati
= polazak ???
pozycja = položaj
mało, od czasu do czasu = pomalo
pomóc, pomagać = pomoći
ponijeti ???
popeti ???
poprawiać = popraviti ???
napełnić, wypełnić = popunjavati ???
służbowo = poslovno
wizyta = posjet
wizytator = posjetilac
odwiedzać = posjetiti
= postajati ???
= posuditi ???
całkowicie = potputno ???
potrzebny = potreban
zranić się, rana = povrijediti ???
pozdrawiać = pozdraviti
zapraszać = pozivati
poznać = poznavati
proszek = prašak
kurz = prašina
myć, prać = prati
= pratiti ???
prosto = prav
prawdziwy, realny = pravi
poprawny = pravo
= prebaciti ???
za daleko = predaleko
predati ???
przedstawienie = predstava
przedstawiac, prezentować = predstaviti
przeglądać = pregledati
prekrasan ???
przejście dla pieszych = prelazak
przenocować = prenoćiti
proponowany = preporučen
poprzedni = prethodan ???
= pretjecati ???
za gorąco = prevruć
przetrwać = preživjeti
propozycja, sugestia = prijedlog
prilično ???
okoliczność = prilika ???
= privikavati se ???
atrakcyjny = privlačan (-na)
przyznać = priznavati
brudny = prljav
polaziti ???
= proplanak ???
broszura, prospekt = prospekt
przestronny = prostran ???
provjeriti ???
pryskać = prskati ???
szynka suszona = pršut
ptak = ptica
dmuchać = puhati
dużo, wiele = puno
palić = pušiti
tor = putanja
radosny = radostan
dopytywać się = raspitati se ???
rosnąć = rasti
różne = razan, razni
zachorować = razboljeti se
293




ž
š
č
đ
